プライシング設計の例を製品名と併せて30個

以下はプライシング設計の例と製品名の一例です。

フリーミアム: Dropbox
付加価値訴求: Apple MacBook Pro
利用時間に応じた課金: Netflix
カスタマイズによる価格変動: Dell
個数割引: Amazon
階層型価格設計: Adobe Creative Cloud
限定販売: Supreme
量産品低価格戦略: IKEA
質の高さによるプレミアム価格: Tesla Model S
販売地域による価格差: McDonald's
オプション課金: Evernote
契約期間に応じた価格設定: AT&T
集客増加による低価格戦略: Uber
利用頻度に応じた課金: ClassPass
セット販売: Starbucks
季節限定商品: Häagen-Dazs
誕生日割引: Sephora
プレオーダー価格: Sony PlayStation 5
取り扱い店舗による価格設定: Whole Foods
アフィリエイトマーケティング: Rakuten
パッケージデザインによる価格差: Coca-Cola
前払い割引: T-Mobile
サブスクリプションモデル: Spotify
仲介手数料: Airbnb
セールイベント: Zara
無料プランの廃止: LinkedIn
販売個数に応じた価格変動: Costco
ブランド認知度による価格差: Louis Vuitton
一定期間の利用制限: Grammarly
早期支払い割引: Verizon Wireless